111100000000000
122111000000000
124221110000000
124242211100000
124242422111000
124242422221000
124242212221100
124221124442100
162111122222110
112121344444310
012111333333311
012223555555531
011113333333331
000011111111111