000001111
000111221
000122221
000122121
000142131
000122121
000142131
000122121
111142131
126222221
122212211
111111110