00111000
00131000
00121111
11142431
13246111
11114100
00013100
00011100