01111110
11222211
12424421
13333331
12442421
11162111
00111100