000000000111110000
000001111122111110
000001223142224210
000001213244426211
000001223142224221
000001113122424221
000000013221142111
011111115111342100
012422223333111100
112141443333100000
122424222133100000
122222422133100000
122111111111100000
111110000000000000